11111111111111111111
1C0000000000C0000001
1EC000P00000000C0001
1C0000000000C0000001
11111111111111111111