11111111111111111111
10001000000C000000E1
10E010P0000000000001
1B001000C00000C00001
11111111111111111111