11111111111111111111111111111111
10000110000000000110000110000001
101CC1101CC1101CC1101CC1101CC0C1
10111110111110111110111110111011
1P00011P00011P00011P00011P000001
10000110000110000110000000000001
10010110010110010110010110010C01
1001E110010110010110010110011111
100000000001100001100001100000C1
10011110011110011110011110011011
1001C11001C11001C11001C11001C0C1
1C00011C00011C00000C00011C000001
10111110111110111110111110111011
101CC1101CC1101CC1101CC1101CC0C1
100001100001100001100001100000B1
11111111111111111111111111111111