11111111111111111111111111111111
1PC1CCCC11C111CCCCCC1111CCC11CR1
11C1111CCCC11CC1111CCCC111CCCCC1
11CCCC11C1111C11111C11C111111C11
11111C11C1111CC1111C11CCC1111C11
1CCCCC11CCCC11C1111CC111CC111C11
1C1C1C11C11111CCCC11C1111C111C11
1C1C1C11CCCC11111C1CC1CCCCCCCC11
111C1C11111CCC111C1C11C111111111
111C1CCCCCCC1C111C1C11C1111CCCC1
1CCC1C11111C1C111C1C1CC1111C11C1
11CCCC111CCC1C111C1C1C11111C11C1
111C11111C111C111C1C1CCCCCCC1CC1
111CCC111CCCCCCT111C111111111C11
11CC111BCC1111111CCCCCCCCCCC1CE1
11111111111111111111111111111111